XXXXXXXXXXXXXXXX
XIIIIIIIIIIIIIIX
XIIBBBBIIBBBBIIX
XIIBIII@@IIIBIIX
XIIBIIIIIIIIBIIX
XIIBIIEEEEIIBIIX
IIII@II?III@IIII
IIII@II$III@IIII
XIIBIIEEEEIIBIIX
XIIBIIIIIIIIBIIX
XIIBIII@@IIIBIIX
XIIBBBBIIBBBBIIX
XIIIIIIIIIIIIIIX
XXXXXXXXXXXXXXXX