XXXXXXXXXXXXXXXX
X$IIIII%IIIIII$X
XI&IIIII%IIII&IX
XIIIEII$IIIEIIIX
XIIIEII$IIIEIIIX
XIIIEII$IIIEIIIX
IIIIEII$IIIEI@II
IIIIEII$IIIEI@II
XIIIEII$IIIEIIIX
XIIIEII$IIIEIIIX
XIIIEII$IIIEIIIX
XI&IIIII%IIII&IX
X$IIIII%IIIIII$X
XXXXXXXXXXXXXXXX