RRRRRRR1RRRRRRRR
RLLLLLLLLLLLLLLR
RLLLLL&&&LLLLLLR
RLLLLLLLLLLLLLLR
RLLLLLLLLLLLLLLR
RLLLLLLLLLLL!LLR
LLLLLLL%LLLLLLLL
LLLLLLL%LLLLLLLL
RLLLLLLLLLLL!LLR
RLLL!LLL!LLLLLLR
RLLLLLLLLLLLLLLR
RLLLLLLLL!LLLLLR
RLL!LLLLLLLLLLLR
RRRRRRRLLRRRRRRR