RRRRRRRR1RRRRRRR
RL^LLLLLLLLLL^LR
RLLLLLLLLLLLLLLR
RLLLLLLLLLLLLLLR
RLLLLLLHHLLLLLLR
LLLLLLHHHHLLLLLL
LLLLLHHHHHHLLLLL
LLLLLLLHHLLLLLLL
LLLLLLLHHLLLLLLL
RLLLLLLHHLLLLLLR
RLLLLLLLLLLLLLLR
RLL&LLLLLLLLLLLR
RLLLLLLLLLLLLLLR
RRRRRRLLLLRRRRRR