RRRRRRWWWWRRRRRR
RLLLLLWWWWLLLLLR
RLLLLLWWWWLLLLLR
RLLLLLWWWWLLLLLR
RLLLLLWWWWLLLLLR
LLLLLLWWWWLLLLLL
LLLLLLGGGGLLLLLL
LLLLLLGGGGLLLLLL
LLLLLLWWWWLLLLLL
RLLLLLLWWWWLLLLR
RLLLLLLLWWWWLLLR
RLLLLLLLLWWWWLLR
RLLLLLLLLLWWWWLR
RRRRRRLLLLWWWWRR