XXXXXXXXXXXXXXXX
X$IIIIIIIIIIII$X
XI!IIIIIIIIII!IX
XIIIEII@IIIEIIIX
XIIIEIIIIIIEIIIX
XIIIEIIIIIIEIIIX
IIIIEIIIIIIEIIII
IIIIEII$IIIEIIII
XIIIEIIIIIIEIIIX
XIIIEIIIIIIEIIIX
XIIIEII@IIIEIIIX
XI!IIIIIIIIII!IX
X$IIIIIIIIIIII$X
XXXXXXXXXXXXXXXX