RRRRRRLLLLRRRRRR
RFFFLLLLLLLLFFFR
RF^FLLLLLLLLF^FR
RFFFLLLLLLLLFFFR
RLLLLLLLLLLLLLLR
LLLLLL&LLLLLLLLL
LLLLLLLLLLLLLLLL
LLLLLLLLLLLLLLLL
LLLLLLLLLLLLLLLL
RLLLLLLLLLLLLLLR
RLLLLLLLLLLL&LLR
RLLDLLLLLLLLLLLR
RLLLLLLLULLLLLLR
RRRRRRRRRRRRRRRR