XXXXXXXXXXXXXXXX
XIIIIIITTIIIIIIX
XIITIII@@IIITIIX
XIIITIIIIIITIIIX
XIIIITIIIITII#IX
XIIIIITIITIIIIIX
IIII#II$$IIIIIII
IIII#ITIITIII#II
XIII#TIIIITIIIIX
XIIITIIIIIITIIIX
XIITIIIIIIIIT#IX
XIIIIII@@IIIIIIX
XIIIIIITTIIIIIIX
XXXXXXXXXXXXXXXX