XXXXXXXIIXXXXXXX
X$IIIIII%IIIII$X
XI&IIIIIIIII@IIX
XI&IEIIIIIIEIIIX
XI&IEIIIIIIEIIIX
XIIIEIIIIIIEIIIX
IIIIEIIIIIIEIIII
IIIIEII$IIIEIIII
XIIIEIIIIIIEIIIX
XIIIEI#II!IEIIIX
XI#IEIIIIIIEIIIX
XIIIIII#IIII%IIX
X$II#IIIII#III$X
XXXXXXXXIXXXXXXX