RRRRRRLLLLRRRRRR
RLLLLLLLLLLLLLLR
RLLLLLLLLLLL&LLR
RLLLLLLLLLLLLLLR
RLLLLFFFFFLLLLLR
LLLLLFBBBFLLLLLL
LLLLLFBEBFLLLLLL
LLLLLFBBBFLLLLLL
LLLLLFFFFFLLLLLL
RLLLLLLLLLLLLLLR
RLLL&LLLLLLLLLLR
RLLLLLLLLLLL^LLR
RLLLLLLLLLLLLLLR
RRRRRRRRRRRRRRRR