XXXXXXXXXXXXXXXX
XIIIIIIIIIIIIIIX
XIIIIII{IIIIIIIX
XIIIIIIIIIIIIIIX
XIIIIIIIIIIIIIIX
XIIIIIIIIIIIIIIX
XIIIIIIIIIIIIIII
XIIIIIIIIIIIIIII
XIIIIIIIIIIIIIIX
XIIIIIIIIIIIIIIX
XIIIIIIIIIIIIIIX
XIIIIIIIIIIIIIIX
XIIIIIIIIIIIIIIX
XXXXXXXXXXXXXXXX