RRRRRRLLLLRRRRRR
RLLLLLLLLLLLLLLR
RLLLLLLLLLLLLLLR
RLLLLLLLLLLLLLLR
RLLLLLLLLLLLLLLR
RLLLLLLLLLLLLLLL
RLLLLLLLLLLLLLLL
RLLLLLLLLLLLLLLL
RLLLLLLLLLLLLLLL
RLLLLLLLLLLLLLLR
RLLLLLLLLLLLLLLR
RLLLLLLLLLLLLLLR
RLLLLLLLLLLLLLLR
RRRRRRRRRLLLLRRR