XXXXXXXXXXXXXXXX
XIII%II%II%IIIIX
XIIBBBBBBBBBBIIX
XIIIIIIIIIIIII%X
XIIBIIIIIIIIBIIX
XIIBIIITTIIIBIIX
IIIBIIII@IIIBIII
IIIBIIII@IIIBIII
XIIBIIITTIIIBIIX
XIIBIIIIIIIIBIIX
XIIIIIIIIIIIII%X
XIIBBBBBBBBBBIIX
XII%III%IIII%IIX
XXXXXXXXXXXXXXXX