XXXXXXXXXXXXXXXX
XII%IIITTIII%IIX
XIITIIIIIIIITIIX
XIIITII###ITIIIX
XIIIITIIIITIIIIX
XII@IITIITII@IIX
IIIIIII$$IIIIIII
IIIIIITIITIIIIII
XII@ITIIIITI@IIX
XIIITIIIIIITIIIX
XIITIII###IITIIX
XIIIIIIIIIIIIIIX
XIII%IITTIII%IIX
XXXXXXXXXXXXXXXX