XXXXXXXIIXXXXXXX
XIIIIIIIIIIIIIIX
XIIIIIIIIIIIIIIX
XIIIIIIIIIIIIIIX
XIIIIIIIIIIIIIIX
XIIIIIIIIIIIIIIX
IIIIIIIIIIIIIIIX
IIIIIIIIIIIIIIIX
XIIIIIIIIIIIIIIX
XIIIIIIIIIIIIIIX
XIIIIIIIIIIIIIIX
XIIIIIIIIIIIIIIX
XIIIIIIIIIIIIIIX
XXXXXXXIIXXXXXXX