XXXXXXXXXXXXXXXX
XIIIIIIIIIIIIIIX
XIIIIIIIIIIIIIIX
XIIIIIIIIIIIIIIX
XIIIIIIIIIIIIIIX
XIIIIIIIIIIIIIIX
XIIIIIIIIIIIIIIX
XIIIIIIIIIIIIIIX
XIIIIIIIIIIIIIIX
XIIIIIIIIIIIIIIX
XIIIIIIIIIIIIIIX
XIIIIIIIIIIIIIIX
XIIIIIIIIIIIIIIX
XXXXXXXXXXXXXXXX