RRRRRRLLLLWWWWRR
RLLLLLLLLLWWWWLR
RLLLLLLLLLWWWWLR
RLLLLLLLLWWWWLLR
RLLLLLLLWWWWLLLR
LLLLLLLWWWWLLLLL
LLLLLLGGGGLLLLLL
LLLLLLGGGGLLLLLL
LLLLLLWWWWLLLLLL
RLLLLLWWWWLLLLLR
RLLLLLWWWWLLLLLR
RLLLLLWWWWLLLLLR
RLLLLLWWWWLLLLLR
RRRRRRWWWWRRRRRR