XXXXXXXXXXXXXXXX
XIIIIIIIIIIIIIIX
XIIBBBIIIIBBBIIX
XIIBIIIIIIIIBIIX
XIIBI!IIII!IBIIX
XIIIIIIIIIIIIIIX
IIIIIIIEEIIIIIII
IIIIIIIEEIIIIIII
XIIIIIIIIIIIIIIX
XIIBI!IIII!IBIIX
XIIBIIIIIIIIBIIX
XIIBBBIIIIBBBIIX
XIIIIIIIIIIIIIIX
XXXXXXXXXXXXXXXX