XXXXXXXXXXXXXXXX
XIIIII#IIIIIIIIX
XIIBBBBBBBBBBIIX
XIIIIIIIIIIIII%X
XIIBII#IIIIIBIIX
XIIBIIITTIIIBIIX
IIIBIIIIIIIIBIII
IIIBIIIIII#IBIII
XIIBIIITTIIIBIIX
XIIBII#IIIIIBIIX
XIIIIIIIIIIIII%X
XIIBBBBBBBBBBIIX
XIIIIIIIII#IIIIX
XXXXXXXXXXXXXXXX