XXXXXXXXXXXXXXXX
XIIIIIITTIIIIIIX
XIITIIIIIIIITIIX
XIIITIIIIIITIIIX
XIIIITIIIITIIIIX
XII&IITIITII&IIX
IIIIIII$$IIIIIII
IIIIIITIITIIIIII
XII&ITIIIITI&IIX
XIIITIIIIIITIIIX
XIITIIIIIIIITIIX
XIIIIIIIIIIIIIIX
XIIIIIITTIIIIIIX
XXXXXXXXXXXXXXXX