RRRRRRRRRRRRRRRR
RLLLLLLL&LLLLLLR
RLLLDLLLLLLLDLLR
RLLLLLLULLLLLLLR
RLLLLLLLLLLLULLR
LLLLLLLLLLLLLLLL
LLLLLLLLLLLLLLLL
LLLLLLLLLLLLLLLL
LLLLLLLLLLLLLLLL
RLLLLLLLLLLLLLLR
RFFFLLLLLLLLFFFR
RF^FLLLLLLLLF^FR
RFFFLLLLLLLLFFFR
RRRRRRLLLLRRRRRR